1111111111111111111111111111111111111111111111111111111111111111
1000000000000000000000000000000000000000000000000000000000000001
1000000000000000000000000000000C00000000000000000000000000000001
1000000000000010011111111000000C00000002000000000000000000000001
1000000000000100000000001000000C00000000000000200000000000000001
1000000000001000000000001000000C00000000000000000000000000000001
100000000P010000000000001000000C00000000000000000000000000000001
1000000000100010000000001000000C0000000000000E000000000000000001
1000000001111110011111111000000C00000000000000000000000000000001
1000000000000010010000000000000C00000000000000000000000000000001
1000000000000010010000000000000C00000000000000000000000000000001
1000000000000010010000000000000C00000000000000000000000000000001
1000000000000010011111111000000C00000000000000000000000000000001
1000000000000000000000000000000C00000000000000000000000000000001
1000000000100010000000001000000C00000000000000000000000000000001
1000000001111110011111111000000C00000000000000000000000000000001
1000000000000010010000000000000C00000000000000000000000000000001
1000000000000010010000000000000C00000000000000000000000000000001
1000000000000010010000000000000C00000000000000000000000000000001
1000000000000010010000000000000C00000000000000000000000000000001
1000000000000010010000000000000C00000000000000000000000000000001
1000000000000010010000000000000C00000000000000000000000000000001
1000000000000000000000000000000C00000000000000000000000000000001
1000000000000010011111111000000C00000000000000000000000000000001
1000000000000100000000001000000C00000000000000000000000000000001
1000000000001000000000001000000C00000000000000000000000000000001
1000000000010000000000001000000C00000000000000000000000000000001
1000000000100010000000001000000C00000000000000000000000000000001
1000000001111110011111111000000C00000000000000000000000000000001
1000000000000010010000000000000C00000000000000000000000000000001
1000000000000010010000000000000C00000000000000000000000000000001
1000000000000010010000000000000C00000000000000000000000000000001
1000000000000010011111111000000C00000000000000000000000000000001
1000000000000000000000000000000C00000000000000000000000000000001
1000000000100010000000001000000C00000000000000000000000000000001
1000000001111110011111111000000C00000000000000200000000000000001
1000000000000010010000000000000C00000000000000000000000000000001
1000000000000010010000000000000C00000000000000000000000000000001
1000000000000010010000000000000C00000000000000000000000000000001
1000000000000010010000000000000C00000000000000000000000000000001
1000000000000010010000000000000C00000000000000000000000000000001
1000000000000010010000000000000C00000000000000000000000000000001
1000000000000010010000000000000C00000000000000000000000000000001
1000000000000010010000000000000C00000000000000000000000000000001
1000000000000010010000000000000C00000000000000000000000000000001
1000000000000010010000000000000C00000000000000000000000000000001
1000000000000010010000000000000C00000000000000000000000000000001
1111111111111111111111111111111111111111111111111111111111111111