111111111111111111
111PC0000111111E11
111111111111111111
