11111111111111111
10000020000000001
10000P00011000001
100C0000001000001
1000000CE11000001
11111111111111111